#############
#           #
# X     PX  #
#####   O   #
#   #       #
#   #       #
#O  #       #
#   #    X  ##############
#   X                    #
#          X     O       #
#   O                    #
########      ############
       #      #
       #  O   #
       ########