##################
#    P  X   O    #
#                #
#    O   XX      #
#                #
#O               #
##################