##########################
#   O            P       #
#                 X      #
########       ###########
       #########

############
#          #
###########