111111111111111111111111111111
100000000000000000000000000001
100000000000000000000000000001
100000000000000000000000000001
100050001000000000000100050001
100000001000000000000100000001
100000001000000000000100000001
100000001000000000000100000001
100011111000000000000111110001
100000000000000000000000000001
100000000000000000000000000001
100000000000000000000000000001
100000000000100001000000000001
100000000000100001000000000001
100000000000100001000000000001
100000000000100001000000000001
100000000000100001000000000001
100000000000000000000000000001
100000000000023340000000000001
100000000000000000000000000001
100000000000000000000000000001
100011111000000000000111110001
100000001000000000000100000001
100000001000000000000100000001
100000001000000000000100000001
100050001000000000000100050001
100000000000000000000000000001
100000000000000000000000000001
100000000000000000000000000001
111111111111111111111111111111