0000000000000000000000000
0000000000000000000000000
0000000000000000000000000
0000000000000000000000000
0000000000000000000000000
0000000000000000022222222
0000002222222222200000000
0000000011100000000110000
0000000000000000000000000