   ####  ###   ###  ####
   #  #  # #   #P#  #  #
   #  #  # #   # #  #  #
   #  #  # #   # #  #  #
   #  #  # #   # #  #  #
####  #  # ##### #  #  #####
#     #  #  O X  #  #      #
#######  #########  ########