              ######
              # O O#
              #    #
              #    #
              #    #
              #    #
              #  P #
              #    #
              #    #
         ######    ######
         #  X        X  #
         #              #
         ################